###############################################
#.............................................#
#...............t.............................#
#.............................................#
#.............................................#
#.............................................#
#...............g.......@.....................#
#.............................................#
#.............................................#
#.............................................#
#.............................................#
#.............................................#
#.............................................#
###############################################