###############################################
#.............................................#
#.............................................#
#.............................................#
#.............................................#
#.............................................#
#.......................@.....................#
#.............................................#
#.............................................#
#.............................................#
#.............................................#
#.............................................#
#.............................................#
###############################################